11001 0 1 1 1 1 1 1 11 1 1 1 1 1 1 101 11001
11001 110 10101 10110 10110 10110 10110 10110 10110 10110 10110 10110 10110 10110 10100 111 11001
11001 110 10111 1111 1111 1111 1111 1111 1111 1111 1111 1111 1111 1111 11000 111 11001
11001 110 10111 1111 1111 1111 1111 1111 1111 1111 1111 1111 1111 1111 11000 111 11001
11001 110 10111 1111 1111 1111 1111 1111 1111 1111 1111 1111 1111 1111 11000 111 11001
11001 110 10111 1111 1111 1111 1111 1111 1111 1111 1111 1111 1111 1111 11000 111 11001
11001 110 10111 1111 1111 1111 1111 1111 1111 1111 1111 1111 1111 1111 11000 111 11001
11001 110 10111 1111 1111 1111 1111 1111 1111 1111 1111 1111 1111 1111 11000 111 11001
11001 110 10111 1111 1111 1111 1111 1111 1111 1111 1111 1111 1111 1111 11000 111 11001
11001 110 10111 1111 1111 1111 1111 1111 1111 1111 1111 1111 1111 1111 11000 111 11001
11001 110 10111 1111 1111 1111 1111 1111 1111 1111 1111 1111 1111 1111 11000 111 11001
11001 110 10111 1101 1101 1101 1101 1101 1101 1101 1101 1101 1101 1101 11000 111 11001
11001 1000 1010 1010 1010 1010 1011 10010 10001 10011 1100 1010 1010 1010 1010 1001 11001