0 1 1 1 1 3 1 1 1 1 5 6 6 6 6 6 6
18 14 15 15 15 15 15 15 15 13 19 6 6 6 6 6 6
18 16 7 8 8 8 8 8 7 17 19 6 6 6 6 6 6
18 16 8 9 6 6 6 9 8 17 19 6 6 6 6 6 6
18 16 8 6 9 6 9 6 8 17 19 6 6 6 6 6 6
18 16 8 6 6 9 6 6 8 17 19 6 6 6 6 6 6
18 16 8 6 9 6 9 6 8 17 19 6 6 6 6 6 6
18 16 8 9 6 6 6 9 8 17 19 6 6 6 6 6 6
18 16 7 8 8 8 8 8 7 17 19 6 6 6 6 6 6
18 16 6 6 6 6 6 6 6 17 19 6 6 6 6 6 6
20 22 22 23 11 10 12 24 22 22 21 6 6 6 6 6 6
6  6  6  6  6  6  6  6  6  6  6  6 6 6 6 6 6
